[woost.extensions]
annotations = woost.extensions.annotations:AnnotationsExtension
audio = woost.extensions.audio:AudioExtension
blocks = woost.extensions.blocks:BlocksExtension
campaign3 = woost.extensions.campaign3:CampaignMonitor3Extension
campaignmonitor = woost.extensions.campaignmonitor:CampaignMonitorExtension
comments = woost.extensions.comments:CommentsExtension
countries = woost.extensions.countries:CountriesExtension
ecommerce = woost.extensions.ecommerce:ECommerceExtension
externalfiles = woost.extensions.externalfiles:ExternalFilesExtension
facebookpublication = woost.extensions.facebookpublication:FacebookPublicationExtension
googleanalytics = woost.extensions.googleanalytics:GoogleAnalyticsExtension
googlesearch = woost.extensions.googlesearch:GoogleSearchExtension
issuu = woost.extensions.issuu:IssuuExtension
locations = woost.extensions.locations:LocationsExtension
mailer = woost.extensions.mailer:MailerExtension
notices = woost.extensions.notices:NoticesExtension
opengraph = woost.extensions.opengraph:OpenGraphExtension
payments = woost.extensions.payments:PaymentsExtension
pdf = woost.extensions.pdf:PDFExtension
recaptcha = woost.extensions.recaptcha:ReCaptchaExtension
restrictedaccess = woost.extensions.restrictedaccess:RestrictedAccessExtension
shop = woost.extensions.shop:ShopExtension
shorturls = woost.extensions.shorturls:ShortURLsExtension
signup = woost.extensions.signup:SignUpExtension
sitemap = woost.extensions.sitemap:SitemapExtension
staticsite = woost.extensions.staticsite:StaticSiteExtension
surveys = woost.extensions.surveys:SurveysExtension
textfile = woost.extensions.textfile:TextFileExtension
tv3alacarta = woost.extensions.tv3alacarta:TV3ALaCartaExtension
twitterpublication = woost.extensions.twitterpublication:TwitterPublicationExtension
usermodels = woost.extensions.usermodels:UserModelsExtension
variables = woost.extensions.variables:VariablesExtension
vimeo = woost.extensions.vimeo:VimeoExtension
webconsole = woost.extensions.webconsole:WebConsoleExtension
youtube = woost.extensions.youtube:YouTubeExtension

