[plainbox.buildsystem]
go = plainbox.impl.buildsystems:GoBuildSystem
make = plainbox.impl.buildsystems:MakefileBuildSystem
autotools = plainbox.impl.buildsystems:AutotoolsBuildSystem

[plainbox.unit]
template = plainbox.impl.unit.template:TemplateUnit
category = plainbox.impl.unit.category:CategoryUnit
test plan = plainbox.impl.unit.testplan:TestPlanUnit
unit = plainbox.impl.unit.unit:Unit
manifest entry = plainbox.impl.unit.manifest:ManifestEntryUnit
job = plainbox.impl.unit.job:JobDefinition
exporter = plainbox.impl.unit.exporter:ExporterUnit
packaging meta-data = plainbox.impl.unit.packaging:PackagingMetaDataUnit

[plainbox.exporter]
rfc822 = plainbox.impl.exporter.rfc822:RFC822SessionStateExporter
json = plainbox.impl.exporter.json:JSONSessionStateExporter
xlsx = plainbox.impl.exporter.xlsx:XLSXSessionStateExporter [xlsx]
jinja2 = plainbox.impl.exporter.jinja2:Jinja2SessionStateExporter
text = plainbox.impl.exporter.text:TextSessionStateExporter

[console_scripts]
plainbox = plainbox.public:main
stubbox = plainbox.impl.box:stubbox_main
plainbox-trusted-launcher-1 = plainbox.impl.secure.launcher1:main
plainbox-qml-shell = plainbox.qml_shell.qml_shell:main

[plainbox.transport]
stream = plainbox.impl.transport:StreamTransport
file = plainbox.impl.transport:FileTransport

[plainbox.parsers]
regex = plainbox.impl.xparsers:Re.parse
pxu-override = plainbox.impl.xparsers:FieldOverride.parse
pxu = plainbox.impl.secure.rfc822:load_rfc822_records
whitelist = plainbox.impl.xparsers:WhiteList.parse

